兰蔻	(LANCOME)
娇兰	(Guerlain)
沙宣	(VS)
迪奥	(Dior)
黛珂	(Cosme Decorte)
水光	(JAYJUN)
大使	(delsey)
白金	(PLATINUM)
天鹅	(SWAN)
兰芝	(LANEIGE)
安利	(Amway)
星空	(XINGKONG)
银河	(YINHE)
倩碧	(CLINIQUE)
科普	(KEPU)
梦妆	(Mamonde)
花印	(HANAJIRUSHI)
安瓶	(CEMOY)
玉泽	(Dr.Yu)
飞科	(FLYCO)
戴森	(Dyson)
小样	(XIAOYANG)
羽西	(YUE-SAI)
戚薇	(QI WAVE)
碧柔	(Biore)
雅漾	(AVENE)
依泉	(Uriage)
花王 	(KAO)
韩束	(KanS)
美素	(MAYSU)
绿叶	(Green Leaf)
韩后	(Hanhoo)
魅影	(MEIying)
高丝	(KOSE)
晚安	(goodnight)
完美	(PERFECT)
松下	(Panasonic)
丸美	(MARUBI)
橘色	(JUSE)
小米	(MI)
大师	(master's mark)
乐敦	(ROHTO)
三福	(SANFU)
法国	(巴黎)含气天然矿泉水
卡诗	(KERASTASE)
卡婷	(CATKIN)
袋鼠	(DaiShu)
潘婷	(PANTENE)
贵妇	(DIAFORCE)
希芸	(syrinx)
透真	(LUCENBASE)
兰花	(lanhua)
美即	(MG)
魅可	(M.A.C)
春雨	(PAPARECIPE)
瓷肌	(SPA CHNSKIN)
热风	(hotwind)
小林	(KOBAYASHI)
强生	(Johnson)
欧珑	(Atelier Cologne)
阿芙	(AFU)
霸王	(BAWANG)
滴露	(Dettol)
博朗	(BRAUN)
艺星	(EALSEM)
狮王	(LION)
伊索	(AESOP)
慕思	(de RUCCI)
樱花	(SAKURA)
华帝	(VATTI)
乐得	(LORD)
贝印	(KAI)
谜尚	(Missha)
斑马	(ZEBRA)
蜗牛	(WONNY)
姬芮	(Za)
天坛	(TianTan)
肌研	(HadaLabo)
苹果	(APPLE)
雅芳	(AVON)
颐莲	(RELLET)
枫叶	(leaveland)
安美	(amy)
曼丹	(Mandom)
猫眼	(CATEYE)
萝莉	(LOLI)
新碧	(SUNPLAY)
谷雨	(GOODWAY)
女神	(YEOSIN)
魔法	(MOFA)
润色	(RUNSE)
罗曼	(ROAMAN)
蝴蝶	(Butterfly)
全球	(QUAN QIU)
派斯	(PSI)
豆乳	(MISS FACE)
慕金	(SMOOTHSKIN)
迷你	(MINI)
薇姿	(VICHY)
欣兰	(DMC)
日上	(RISHANG)
公主	(gongzhu)
拜尔	(BAIR)
大米	(DAMI)
井田	(Canmake)
旁氏	(POND'S)
兰瑟	(LANSUR)
飘柔	(Rejoice)
凡茜	(Fanxishop)
施巴	(sebamed)
火车	(Train)
欧蕙	(OHUI)
朵色	(DVZ')
人生	(rensheng)
泰迪	(TEDDY)
莫杰	(MARC JACOBS)
米奇	(Mickey)
大哥	(Koh-Kae)
高姿	(COGI)
猫咪	(catmi)
美诺	(MIELE)
纳斯	(NARS)
深海	(DeepOcean)
锐度	(RD)
鳄鱼	(LACOSTE)
金色	(domaci)
晨曦	(CHENXI)
滋源	(seeyoung)
水晶	(CRYSTAL)
英树	(INGLEMIREPHARM’S)
黑人	(DARLIE)
爱敬	(AEKYUNG)
健身	(jianshen)
卡奇	(Kaqi)
米菲	(MIFFY)
吉列	(Gillette)
早安	(morningsun)
吾诺	(UNO)
红酒	(uuine)
唯资	(VEECCI)
姚明	(YAOMING)
秀碧	(Contractubex)
如新	(Nu Skin)
晓姿	(AXXZIA)
芳珂	(FANCL)
华为	(HUAWEI)
欧树	(Nuxe)
凯特	(KATE)
素萃	(Sucui)
赫拉	(Hola)
凯卓	(KENZO)
华美	(Huamei)
三角	(Triangle)
宝丽	(POLA)
多芬	(Dove)
博士	(Doctor)
荷诺	(histoire naturelle)
贝拉	(bella)
德妃	(DERMAFIRM)
明色	(MEISHOKU)
珂润	(Curel)
马油	(LOSHI)
欧乐	(Euro)
未来	(VAPE)
室内	(Snnei)
倩丽	(CEZANNE)
宝拉	(POLLA)
初颜	(CHUYAN)
熊猫	(PANDA)
罗马	(ROAMER)
乐活	(LOHO)
赫妍	(HERA)
杜克	(DUC)
原辰	(WONJIN)
韩纪	(HanKey)
呵护	(HEHU)
金地	(GOLDENLAND)
卞卡	(BINCA VIDOU)
泊美	(PURE＆MILD)
光芮	(GLO&RAY)
梅花	(Titoni)
悦薇	(Revital)
舒适	(Schick)
迷奇	(MIRACLE)
悠宜	(UNNY CLUB)
青蛙	(qingwa)
大创	(DAISO)
凌仕	(LYNX)
南方	(NANFANG)
月立	(yueli)
赛格	(SIEGE)
丹姿	(DANZ)
泰勒	(TAYLOR)
希澈	(Xiche)
雅萌	(YA-MAN)
诺为	(KNORVAY)
陌森	(Molsion)
小狗	(puppy)
星辰	(XINGCHEN)
鹦鹉	(YINGWU)
绿洲	(LZZ)
米兰	(MiLan)
万宁	(mannings)
欧蒙	(oputemon)
腾讯	(Tencent)
奥普	(AUPU)
大众	(Volkswagen)
卫宝	(lifebuoy)
日光	(Sunsweet)
俪兰	(LEELAN)
卡蔓	(Casmara)
韩雪	(hanxue)
柏氏	(PAT'S)
海信	(Hisense)
春纪	(HARUKI)
艾琳	(A)
美的	(Midea)
艾菲	(aifei)
韩律	(HANYUL)
宫灯	(gongdeng)
美图	(meitu)
美嘉	(MAYGA)
晨光	(M&G)
心愿	(XIN YUAN)
妮可	(Nicole)
萧邦	(CHOBOND)
傲蝶	(Ottie)
天窗	(Sky window)
音符	(AWJS)
得鲜	(the saem)
银钻	(YINZUAN)
珀斯	(Perth)
韩代	(HANDAI)
富士	(FUJIFILM)
速腾	(SUTENG)
奔驰	(benz)
德基	(DEJI)
爱慕	(Aimer)
妆度	(ZoonDuoo)
幽兰	(ORLANE)
三本	(SEMBEM)
黑卡	(Recca)
麻瓜	(MUGGLES)
牛牌	(Cow)
碧唇	(Blistex)
活能	(HUO NENG)
古月	(GUYUE)
米云	(miyun)
立润	(LIRUN)
茅台	(MOUTAI)
薇婷	(VEET)
大赏	(COSME)
飞秒	(FIMORE)
珀薇	(BOVEY)
蓝秀	(LANSHOW)
巴克	(BUCK)
匹奇	(PRITECH)
诗碧	(SHIBI)
大力	(DA LI)
0度	(PERFECTSIGHT)
浪凡	(LANVIN)
添美	(Tianmei)
成田	(Narita)
施蒂	(YCID)
福田	(FUTINA)
清水	(SHIMIZU)
高野	(GAOYE)
膜玉	(candymoyo)
晶硕	(keesoo)
珂曼	(CAREMILLE)
允薇	(YOUWELL)
滨田	(Hamada)
萌宝	(Cutebaby)
卓韵	(zhuoyun)
飞梭	(fisher)
超人	(SID)
芳玑	(AFRELLA)
西屋	(Westinghouse)
洁碧	(Waterpik)
大华	(TAI HUA)
边缘	(FRINGE)
文艺	(WENYI)
米妮	(Minnie)
邦娜	(BANGNA)
凤九	(FENGJIU)
青柚	(Cyan pomelo)
标榜	(biaobang)
超龙	(CHAOLONG)
飘婷	(piaoting)
臻彩	(ZHENCAI)
芮谜	(RIMMEL)
欧享	(Ouxiang)
梧桐	(wtop)
艺声	(ESMOOTH)
诺思	(KNOX)
爱莎	(Aisha)
爱彼	(Audemars Piguet)
驼峰	(CAMELBAK)
七宝	(7BEST)
墨兰	(MOLAN)
莉兹	(leezi)
首页	(THE FIRST PAGE)
美帝	(MEKING)
晶钻	(JINGZUAN)
得宝	(TEMPO)
米家	(MIJIA)
极简	(Jijian)
久光	(Hisamitsu)
拿铁	(Les Lattes)
瑞研	(Ruiyan)
华欣	(HUAXIN)
松岛	(siondu)
吉登	(JIDENG)
白云	(BAIYUN)
雅玺	(YASI)
柯南	(KE NAN)
澳雪	(accen)
佳雪	(CATHY)
大宇	(DAEWOO)
阿诺	(Arno)
亿丰	(YIFENG)
星优	(XINGYOU)
炫诗	(TRESEMME)
名蓝	(MINGLAN)
嘉人	(Marie Claire)
雅蔻	(Ardeco)
欧莱雅	(L'OREAL)
植村秀	(Shu-uemura)
屈臣氏	(Watsons)
美宝莲	(MAYBELLINE)
科颜氏	(Kiehl's)
娇韵诗	(CLARINS)
阿玛尼	(ARMANI)
香奈儿	(Chanel)
资生堂	(Shiseido)
露华浓	(Revlon)
凡士林	(Vaseline)
美妆蛋	(beautyblender)
欧舒丹	(L'OCCITANE)
理肤泉	(LA ROCHE-POSAY)
施华蔻	(Schwarzkopf)
自然堂	(CHANDO)
希思黎	(Sisley)
赫莲娜	(HELIANNA)
比亚迪	(BYD)
卡姿兰	(Carslan)
妮维雅	(NIVEA)
贝玲妃	(Benefit)
珀莱雅	(PROYA)
圣罗兰	(YSL)
雪花秀	(Sulwhasoo)
佰草集	(HERBORIST)
贝德玛	(BIODERMA)
丝芙兰	(SEPHORA)
江原道	(Koh Gen Do)
麦吉丽	(Mageline)
嘉娜宝	(Kanebo)
露得清	(Neutrogena)
雪肌精	(SEKKISEI)
爱马仕	(HERMES)
艾杜纱	(ettusais)
奥尔滨	(ALBION)
蓝精灵	(Lanjingling)
红景天	(HONGJINGTIAN)
玫琳凯	(MARY KAY)
安耐晒	(Anessa)
小奥汀	(littleondine)
碧欧泉	(BIOTHERM)
玫珂菲	(MAKE UP FOR EVER)
林清轩	(Forest cabin)
芦丹氏	(SergeLutens)
欧诗漫	(OSM)
芭妮兰	(banila co)
娥佩兰	(OPERA)
珂莱欧	(CLIO)
飞利浦	(PHILIPS)
宝格丽	(BVLGARI)
艾诺碧	(IOPE)
拉杜丽	(Laduree)
韩妮采	(Heynature)
范思哲	(VERSACE)
巧克力	(chocolate)
思亲肤	(skinfood)
美加净	(MAXAM)
蒂佳婷	(Dr.Jart)
韩熙贞	(HEXZE)
法尔曼	(VALMONT)
温碧泉	(WETHERM)
丝塔芙	(Cetaphil)
阿道夫	(ADOLPH)
雪玲妃	(Xuelinfe)
伊欧诗	(EOS)
野兽派	(THE BEAST)
欧缇丽	(Caudalie)
冰希黎	(Boitown)
祖玛珑	(jomalone)
迪士尼	(Disney)
茵芙莎	(IPSA)
欧姆龙	(OMRON)
葡萄籽	(Healthy care)
艾杜莎	(Ettusais)
安娜苏	(Anna sui)
魅丝蔻	(MSQ)
苏菲娜	(Sofina)
玉兰油	(OLAY)
丽得姿	(LEADERS)
独角兽	(UNICORN)
宋慧乔	(Song Hye  Kyo)
蒲公英	(dandelion)
雅诗敦	(ESTHEDERM)
无花果	(FIG)
黄金棒	(BEAUTY STICK)
悦碧施	(Natura Bisse)
茱莉蔻	(Jurlique)
肌美精	(Kracie)
美肤宝	(MEIFUBAO)
蓓昂斯	(BYPHASSE)
契尔氏	(Kiehl's)
澳尔滨	(AIBION)
三橡树	(3 chenes)
尤妮佳	(MOONY)
三得利	(Suntory)
科莱博	(CLB)
莱珀妮	(La Prairie)
蓝蒂丝	(LADES)
李医生	(DOCTOR LI)
柏瑞美	(PRAMY)
优色林	(Eucerin)
方程式	(FCS)
美人鱼	(Mermaid)
康宝莱	(HERBALIFE)
植美村	(ZMC)
百雀羚	(PECHOIN)
毕加索	(pimio)
奥特曼	(ULTRAMAN)
柠檬草	(LEMON GRASS)
贝佳斯	(Borghese)
韩斯清	(HANSKIN)
洛丽塔	(Lolita Lempicka)
科莱丽	(Clarisonic)
爱茉莉	(Amore)
茜素斯	(SANSSOUCIS)
奥洛菲	(OLEVA)
娜丽丝	(Naris up)
威露士	(Walch)
凯芙兰	(kaifulan)
普拉达	(PRADA)
艾诺琪	(ENERGY)
奥杰尼	(ALGENIST)
花木兰	(HUAMULAN)
馥蕾诗	(Fresh)
真丽斯	(Genlese)
可贝尔	(COBOR)
伊肤泉	(EVE CHARM)
美乐家	(melitta)
帕玛氏	(PALMER’S)
怡思丁	(ISDIN)
爱诗妍	(Exuviance)
小蜜蜂	(bee)
无限极	(INFINITUS)
无硅油	(Reveur SCALP)
益生菌	(Life Space)
奇士美	(kiss me)
艾诗缇	(ASTALIFT)
天露芬	(TAUTROPFEN)
嘉利玛	(GALIMARD)
欧菲姿	(OFFICE)
妙巴黎	(Bourjois)
名古屋	(NAGOYA)
葫芦娃	(HULUWA)
高露洁	(Colgate)
芭乐雅	(Balea)
祖马龙	(JO MALONE)
采之汲	(caizhiji)
拿破仑	(Courvoisier)
帕瑞诗	(Just for you)
菲奥娜	(IFiona)
蕾珂美	(Renkomay)
水之印	(AQUALABEL)
卢丹氏	(Serge Lutens)
拉美拉	(LAMEILA)
老中医	(LAOZHONGYI)
和光堂	(Wakodo)
霏丝佳	(PHYSIOGEL)
小蜜坊	(Manuka bee)
沃尔玛	(Walmart)
柏卡姿	(BOGAZY)
紫罗兰	(Violet)
黑龙堂	(hipitch)
水肌肤	(sweet carefor)
蒙芭拉	(monplay)
比度克	(BeDOOK)
艾米尔	(AMIIR)
愛馬仕	(AIMAS)
艾珂薇	(ACWELL)
哈罗闪	(sanosan)
高柏诗	(GOPAS)
贺本清	(Herbacin)
柏瑞特	(DR BRANDT)
津尔氏	(THAYERS)
若美欣	(Romasin)
安婕妤	(ANGLEE)
佳丽宝	(Kanebo)
柚子舍	(you zi she)
卡乐芙	(OOCLCURFUL)
柯莱欧	(Clio)
罗伯特	(AULOCE)
绵羊油	(aus life)
丝蓓绮	(TSUBAKI)
熊野笔	(PRESENTEDBYSHAKUDA)
赛贝格	(Dr Sebagh)
益若翼	(KOJI)
火山灰	(Brain Cosmos)
艾琳咪	(AILINMI)
爱护佳	(aiHuJia)
婴儿肥	(Baby Fat)
澳佳宝	(Blackmores)
蔓越莓	(Gevita)
露西娅	(Luxiya)
香缇卡	(Chantecaille)
塔莉卡	(TALIKA)
陆心媛	(youk shim won)
太阳社	(Taiyosha)
北极熊	(Polar bear)
花无缺	(flower show)
博莱雅	(Bolaiya)
桃丝熊	(TOUS)
花皙蔻	(CLORISLAND)
御宅女	(OTAKU)
阿瓦隆	(avalon)
南极人	(Nanjiren)
索菲欧	(SOFFIO)
哈密瓜	(HAMIGUA)
桃花源	(TAOHUAYUAN)
忆可恩	(IPKN)
曼哈顿	(Manhattan)
米雪儿	(MichelleYam’sStudio)
雅丽洁	(YALGET)
爱多康	(ATOPALM)
妍诗美	(acymer)
九朵云	(cloud 9)
魔术师	(MAGICIAN)
碧丽珠	(Pledge)
维克多	(VCD)
勒布朗	(Lebron)
艾丝珀	(eSpoir)
三丽鸥	(SANRIO)
悠珂思	(ukiss)
萌牙家	(m-teeth)
蕾哈娜	(LEIHANA)
佑天兰	(Utena)
卡尼尔	(Garnier)
发雅丝	(FAYASI)
雅诗兰黛	(Estee Lauder)
海蓝之谜	(LA MER)
悦诗风吟	(Innisfree)
蜜丝佛陀	(MAXFACTOR)
曼秀雷敦	(Mentholatum)
悦木之源	(Origins)
自然乐园	(NATUREREPUBLIC)
菲丽菲拉	(PERIPERA)
相宜本草	(INOHERB)
无印良品	(MUJI)
肌肤之钥	(Cle de Peau)
伊蒂之屋	(ETUDE HOUSE)
玛丽黛佳	(MARIE DALGAR)
芙丽芳丝	(Freeplus)
城野医生	(Dr.Ci.Labo)
日月晶采	(LUNASOL)
芭比波朗	(Bobbi Brown)
名创优品	(MINGCHUANGUP)
菲诗小铺	(THE FACE SHOP)
深蓝彩妆	(BLEUNUIT)
美丽加芬	(BEAUTYPLUS)
珍草名方	(RARE HERBS)
半亩花田	(Little Dream Garden)
瑞倪维儿	(Rinawale)
美迪惠尔	(Mediheal)
小林制药	(KOBAYASHI)
奥伦纳素	(Erno Laszlo)
水之密语	(AQUAIR)
西甲硅油	(Sab simplex)
宝拉珍选	(Paula's Choice)
蔚蓝之美	(Wei Beauty)
鳄鱼宝宝	(CrocoBaby)
浮生若梦	(MAKE UP FOR EVER)
喜马拉雅	(CNHIMALAYA)
波比布朗	(Bobbi Brown)
汤姆福特	(TOM FORD)
菲拉格慕	(Ferragamo)
爱丽小屋	(ERISE HOUSE)
高丽雅娜	(Coreana)
大卫杜夫	(Davidoff)
德国世家	(Dr.Hauschka)
恋爱魔镜	(Majolica mjorca)
娇兰佳人	(GIALEN)
可口可乐	(Coca-Cola)
自然哲理	(Philosophy)
伊诗贝格	(JOSE EISENBERG)
卡奇色彩	(KCKC COLOR)
近江兄弟	(OMI)
阿里巴巴	(A LI BA BA)
森田药妆	(DR.MORITA)
宝罗丝丹	(BONOSIDAN)
巧迪尚惠	(Qdsuh)
急救美人	(FIRST AID BEAUTY)
阿拉哆哆	(aladuoduo)
康绮墨丽	(DAENG GI MEO RI)
美体小铺	(The Body Shop)
伊卡露诗	(ICARLUS)
完美意境	(INTEGRATE)
卡文克莱	(Calvin Klein)
近江蔓莎	(OMI)
安娜柏林	(Annemarie Borlind)
自然樂園	(Nature republic)
雅莉格丝	(Elegance)
德美乐嘉	(Dermalogica)
海绵宝宝	(Spongebob)
阿司匹林	(Aspirin)
花娜小姐	(Miss hana)
美伊娜多	(DIVUM)
伊犁河谷	(yili valley)
佩翘封面	(Bq.cover)
韩粉世家	(HI-FACE)
宫村浩气	(CREATE ION)
爸爸妈妈	(babamama)
香格里拉	(shangri-la)
雅思兰黛	(Estee Lauder)
法兰琳卡	(FRANIC)
巴黎世家	(BALENCIAGA)
魔法医生	(DR.MAGIC)
秘密花园	(JARDINS SECRETS)
荷兰美素	(Herobaby)
露兰姬娜	(ROLANJONA)
绿光森林	(LaVerte)
巴巴罗莎	(babaluosha)
三草两木	(SASELOMO)
茉贝丽思	(MERBLISS)
完美日记	(PERFECT DIARY)
水果之乡	(welcos)
国家地理	(National Geographic)
上海药皂	(SHANGHAI YAOZAO)
赫丽尔斯	(HELIUS)
玫瑰花蕾	(rosebud)
上海香皂	(SHANGHAI XIANGZAO)
杜嘉班纳	(Dolce&Gabbana)
糖果小姐	(Miss Candy)
封面女郎	(COVER GIRL)
珂丽柏蒂	(CBP)
诗婷露雅	(STEROREA)
呼吸37	(Su:m37&#730;)
乐敦药妆	(Reviya)
拉普瑞斯	(lapulovce)
潘达利亚	(PandAria)
茉贝丽丝	(merbliss)
苏秘37°	(Su:m37°)
巴黎欧莱雅	(LOREAL PARIS)
法国珍贵水	(EAU PRECIEUSE)
格兰玛弗兰	(Glamourflage)
德国小甘菊	(herbacin)
自然共和国	(NATURE REPUBLIC)
服饰与美容	(VOGUE)
维纳斯蒂尔	(RILASTIL)
洛杉矶女孩	(L.A.GIRLS)
石泽研究所	(ishizawa)
南非芦荟胶	(AMC)
LG身体乳	(LG)
氣味圖書館	(SCENT LIBRARY)
